# Glossary in tab-separated format -*- coding: utf-8 -*-
Ecco	Alloddu	Mirai
fiume	arriu	frùmini
cintura	singeddu	cintroxa, lumbus est prus sa parti de a palas
degno	dìnniu	dinnu
Spirito	Spìridu	Spìritu
venne	fiat lòmpiu	lompeit
vangelo	evangèliu
riassettare	assetiai	it. rassettare, fr. arranger, sp. remmendar
spirito	spìridu
pregava	pregàt	in it./sp/ fr non ponet su verbu gerundiu ne inditat un'atzioni chi est cumpria in cussu momentu
venuto	bènniu	s'assegurai de imperai sempri custu
parola	paràula	fueddu; verbu in su Contu
paralitico	màrturu
folla	truma	trumma
lettuccio	letera	lètiga, lètia
uomo	òmini
glorificare	alabantzai	allabantzai; alabai
discepolo	discipulu
pubblicani	pubblicanus
discepoli	discìpulus	scientis
chiamare	circai   (ca Gesùs est circhendi is discìpulus)
otri	urdis	udris
come	comenti
messagero	nùntziu
messaggero	nùntziu
davanti a te	ananti tuu
strada	caminu
a lui	a innui fiat issu
degno	dinnu
Spirito	Spirìdu
Inizio	Cumintzu
preparate	preparai	apariciai
raddrizzate	aparixai	aderetzai
sentieri	àndalas	moris
predicando	predichendi
battesimo	batiari
conversione	cunversioni	pentimentu
Accorreva	acudiat	aprobiàt
Dopo di me	infatu miu
sciogliere	scapiai
legacci	corrias
sandali	sàndulus
